9999999999
9        9
9 s      9
9   kk   9
9   k    9
9o oo    9
9999999999