999999999999999999
9                9
9s               9
9    k o         9
9    k o         9
999999999999999999